##############################
# x  #######  ###    ##     ##
#      ###    #####    ##    #
#     #       #         #    #
#             ####         ###
#   ########  ## ##    ##    #
#   #####       ###          #
#   ####      ##    ###      #
#                      ##    #
#   ##   ###  #####          #
#   ###                #   o #
##############################
