##############################
# x   #######  ###    ##    ##
#      ###             ##    #
#   #         ## ##    ##    #
#             ####         ###
#      #####     ##    ##    #
#   #  ##                    #
#   ####     ######          #
#           #   o    #  #    #
#   ##   ##   #####          #
#                        #   #
##############################
